# Niveau 1
1 1 1 1 1
1 0 3 2 1
1 0 4 0 1
1 1 1 1 1

# Niveau 2
1 1 1 1 1 1 1
1 4 0 0 3 2 1
1 1 1 1 1 1 1

# Niveau 3
1 1 1 1 1 1 1
1 0 0 0 0 0 1
1 0 3 0 3 0 1
1 0 0 4 0 0 1
1 0 2 0 2 0 1
1 0 0 0 0 0 1
1 1 1 1 1 1 1

# Niveau 4
1 1 1 1 1 1 1
1 0 0 0 0 0 1
1 0 1 1 1 0 1
1 0 1 2 1 0 1
1 0 1 3 1 0 1
1 0 0 4 0 0 1
1 1 1 1 1 1 1

# Niveau 5
1 1 1 1 1 1 1 1 1 1
1 0 0 0 1 0 0 0 0 1
1 0 3 0 1 0 3 0 2 1
1 0 0 2 0 3 0 0 2 1
1 1 1 0 1 1 0 1 1 1
1 0 0 0 0 0 0 0 2 1
1 0 0 0 1 0 3 0 0 1
1 0 0 4 0 0 0 0 0 1
1 1 1 1 1 1 1 1 1 1

# Niveau 6
1 1 1 1 1 1 1 1 1
1 0 0 0 1 0 2 2 1
1 0 3 0 0 0 0 0 1
1 0 0 3 1 0 2 2 1
1 1 3 4 0 0 0 0 1
1 0 0 3 1 0 0 0 1
1 0 1 0 1 1 0 0 1
1 0 0 0 0 0 0 0 1
1 1 1 1 1 1 1 1 1

# Niveau 7
1 1 1 1 1 1 1 1 1 1
1 0 0 0 1 0 0 0 0 1
1 0 3 0 1 0 3 0 0 1
1 0 0 0 0 3 0 0 2 1
1 0 3 0 1 0 0 0 0 1
1 1 1 0 1 1 0 1 1 1
1 2 0 0 0 0 0 0 2 1
1 0 0 0 1 1 0 0 0 1
1 0 4 0 0 0 0 2 0 1
1 1 1 1 1 1 1 1 1 1

# Niveau 8
1 1 1 1 1 1
1 0 0 0 0 1
1 0 3 0 4 1
1 1 5 0 0 1
1 0 5 0 1 1
1 0 5 0 1 1
1 0 5 0 1 1
1 0 2 0 1 1
1 1 1 1 1 1